11111111111111
110010C0000001
1110001C000A01
1C000P00110001
1111001C100001
11000001C000E1
11111111111111
