11111111111111111
1P00AC00000000001
111001C0000110001
1C000001100110001
111001C0000110001
110A000C00C0111E1
11111111111111111