11111111111111111111
1P0000C000E000000001
1110001C000001100001
1C000000110001100001
1111001C000001100001
11000000C000E0111001
11111111111111111111