11111111
1P0EC001
11100001
1C000A01
11110001
110000E1
11111111
