1111111
1P0C0C1
1E00011
1C000E1
1111111
