1111111
1P0C0C1
1E00011
1C000C1
1111111
